########################################
#......................................#
#..####..########..####..####..####..#.#
#..####..########..####..####..####..#.#
#................E........E............#
#..####..####..##..##..####..####..##..#
#..####..####..##..##..####..####..##..#
#......................................#
#..####..########..####..####..####..#.#
#..####..########..####..####..####..#.#
#......................................#
#..####..##..##..####..####..##..##..#.#
#..####..##..##..####..####..##..##..#.#
#...................P..................#
#..####..########..####..####..####..#.#
#..####..########..####..####..####..#.#
#......................................#
#..####..##..##..####..####..##..##..#.#
#..####..##..##..####..####..##..##..#.#
#......................................#
#..########..####..####..########..##..#
#..########..####..####..########..##..#
#......................................#
#..####..########..####..####..####..#.#
#..####..########..####..####..####..#.#
#......................................#
#..####..##..##..####..####..##..##..#.#
#..####..##..##..####..####..##..##..#.#
#......................................#
#......................................#
#......................................#
#......................................#
#......................................#
#......................................#
#......................................#
#...................E..................#
#......................................#
#......................................#
#......................................#
########################################